Апельсин - Микан;
Банан - Банана;
Да - Хай;
Италия - Итариа;
Кино - Эига;
Кофе - Кохи;
Мясо - Нико;
Национальность - Джин;
Нет - Иие;
Обувь - Кутсу;
Овощи - Ясаи;
Пиво - Биру;
Приятно познакомиться - Хадзимемаште;
Прошу любить и жаловать - До:зо ёрошку о негасимас;
Рис - Гохан;
Россия - Рошиа;
Рыба - Сакана;
Саке - Осаке;
Сок - Джусу;
Суика - Кабан;
Телевизор - Тереби;
Тоже - Мо;
Франция - Фурансу;
Фрукты - Кудамоно;
Футболка - Тишатсу;
Хлеб - Пан;
Часы - Токей;
Что - Нан;
Это(близко) - Коре;
Это(далеко) - Аре;
Это(у собеседника) - Соре;
Я - Ваташи ва;
Яблоко - Ринго;
Япония - Нихон;