Кофе - Кохи
Пиво - Биру
Фрукты - Кудамоно
Яблоко - Ринго
Апельсин - Микан
Сок - Джусу
Саке - Осаке
Банан - Банана
Овощи - Ясаи
Рис - Гохан
Хлеб - Пан
Футболка - Тишатсу
Мясо - Нико
Рыба - Сакана
Туфли - Кутсу
Сумка - Кабан
Часы - Токей
Кино - Еига
Телевизор - Тереби
Приятно познакомиться - Хадзимемашите
Прошу любить и жаловать - ДоЗо Ёросику О Негасимас
Я - Ваташи
Россия - Рошиа
Япония - Нихон
Италия - Итариа
Франция - Фурансу
Национальность - Джин
Тоже - Мо
Да - Хай
Нет - Иие
Это(близко) - Коре
Это(у собеседника) - Соре
Это(далеко) - Аре
Что - Нан
Цветок - Хана
Боши - Шапка
Доброе утро - Охаё Гозаимас
Привет - Конничива
Добрый вечер - Конбанва
Спасибо(не вежливо) - Аригато
Спасибо - Аригато Гозаимас
Большое спасибо - ДоМо Аригато Гозаимас
Суши - Суси
Палочки для суши - Хаси
Ложка - Спун
Вилка - Фоку
Пожалуйста(когда даешь, чтолибо) - ДоЗо
Зеленый чай - Оча
Черный чай - Коча
Мороженое - Айсукуриму
Немного - Чото
Морковь - Ниндзин
Перец - Пиман
Баклажан - Насу
Картофель - Дзягаимо
Телефон - Денва
Ручка - Пэн
Огурец - Кюри
Капуста - Кябэцу
Яйцо - Тамаго
Нравиться - Суки(Ски)
Я не знаю - Ваташи Ва Вакаримасен
Шоколад - Чокоретто
Птица - Тори
Корова - Уши
Падеж направления - Э
1 - Ичи
2 - Ни
3 - Сан
4 - Ши/Йон
5 - Го
6 - Року
7 - Нана/Сити
8 - Хачи
9 - Ку/Кю:
10 - Джу
100 - Хяку
1000 - Сэн
Час - Джи
Цена - Икура
Тетрадь - Ното
Книга - Хон
Семья - Казоку
Муж - Сюдзин
Жена - Цума/Канаи
Родители - Рёсин
Папа - Тити
Мама - Хаха
Дедушка - Софу
Бабушка - Собо
Суфикст возраста - Саи
Родительный падеж - Но
Работа - Сигото
Проффесия - Сёкугё
Инженер - Гиси
Служащий компании - Кайсяин
Врач - Ися
Парикмахер - Биёси
Домохозяйка - Сюфу
Медсестра - Кангофу
Школьник - Сэйто
Студент - Гакусэй
Программист - Пурагурамисто
Учитель - Сенсей
Министр инностранных дел - Гаймудайдин
Полицейский - Кэисацу
Президент - Дойторё
Продавец - Тенин
Художник - Гака
Водитель - Унтенсю
Музыкант - Онгакука
Лошадь - Ума
Море - Уми
Глаз - Ме