Кохи - Кофе
Биру - Пиво
Кудамоно - Фрукты
Ринго - Яблоко
Микан - Апельсин
Джусу - Сок
Осаке - Саке
Банана - Банан
Ясаи - Овощи
Гохан - Рис
Пан - Хлеб
Тишатсу - Футболка
Нико - Мясо
Сакана - Рыба
Кутсу - Туфли
Кабан - Сумка
Токей - Часы
Еига - Кино
Тереби - Телевизор
Хадзимемашите - Приятно_познакомиться
ДоЗо - Прошу_любить_и_жаловать
Негасимас - Ёросику
Ваташи - Я
Рошиа - Россия
Нихон - Япония
Итариа - Италия
Фурансу - Франция
Джин - Национальность
Мо - Тоже
Хай - Да
Иие - Нет
Коре - Это(близко)
- - Это(у
- - Соре
- - Аре
- - Нан
- - Хана
- - Шапка
Привет - Охаё
Добрый_вечер - -
Спасибо(не - -
Аригато - вежливо)
Аригато_Гозаимас - Спасибо
ДоМо_Аригато_Гозаимас - Большое_спасибо
Суси - Суши
Хаси - Палочки_для_суши
Спун - Ложка
Фоку - Вилка
ДоЗо - Пожалуйста(когда_даешь,_чтолибо)
Оча - Зеленый_чай
Коча - Черный_чай
Айсукуриму - Мороженое
Чото - Немного
Ниндзин - Морковь
Пиман - Перец
Насу - Баклажан
Дзягаимо - Картофель
Денва - Телефон
Пэн - Ручка
Кюри - Огурец
Кябэцу - Капуста
Тамаго - Яйцо
Суки(Ски) - Нравиться
Ваташи_Ва_Вакаримасен - Я_не_знаю
Чокоретто - Шоколад
Тори - Птица
Уши - Корова
- - Падеж
- - Э
- - Ичи
- - Ни
- - Сан
- - Ши/Йон
- - Го
- - Року
- - Нана/Сити
- - Хачи
- - Ку/Кю:
- - Джу
- - Хяку
- - Сэн
- - Джи
- - Икура
- - Ното
- - Хон
- - Казоку
- - Сюдзин
- - Цума/Канаи
- - Рёсин
- - Тити
- - Хаха
- - Софу
возраста - Собо
Родительный - -
Но - падеж
Сигото - Работа
Сёкугё - Проффесия
Гиси - Инженер
Кайсяин - Служащий_компании
Ися - Врач
Биёси - Парикмахер
Сюфу - Домохозяйка
Кангофу - Медсестра
Сэйто - Школьник
Гакусэй - Студент
Пурагурамисто - Программист
Сенсей - Учитель
Гаймудайдин - Министр_инностранных_дел
Кэисацу - Полицейский
Дойторё - Президент
Тенин - Продавец
Гака - Художник
Унтенсю - Водитель
Онгакука - Музыкант
