Цветок - Хана
Шапка - Боши
Охаё: Гозаимас - Доброе утро
Конничива - Добрый день/Привет
Конбанва - Добрый вечер
О-Намае Ва - Как вас зовут?("О" употребляеться как уважение)
Аригато - Спасибо(Не очень вежливо)
Аригато Гозаимас - Спасибо
До:Мо Аригато Гозаимас - Большое спасибо
Суси - Суши
Хаси - Палочки для суши
Ложка - Спу:н
Вилка - Фо:ку
До:зо - Пожалуйста(Когда даёшь что-либо)
Оча - Зеленый чай
Коча - Черный чай
О - Приставка показывающея уважение
Айсукуриму - Мороженое
Чото - Немного(Когда отказываешься)
Морковь - Ниндзин
Перец - Пи:ман
Баклажан - Насу
Картофель - Дзягаймо
Телефон - Денва
Ручка - Пэн
Огурец - Кю:ри
Капуста - Кябэцу
Яйцо - Тамаго
Неко - Кот
Суки(читаеться как ски) - Нравиться(хоть и в русском языке это глагол - в японском это прилагательное, вроде)
Кто-то Ва Что-то Га Суки Дэс - Каркас предложения о том, что что-то нравться
Ваташи Ва Неко Га Суки Дэс - Мне нравятся кошки
|Аната Ва Дзягаймо Га Суки Дэс Ка - Тебе нравитсья картошка?
|Иие, Ваташи Ва Дзягаймо Га Суки Дэва Аримасен - Нет, мне не нравитсья картошка
Боку - Ваташи для маленьких мальчиков