Кофе - Кохи
Пиво - Биру
Яблоко - Рингон
Апельсин - Микан
Сок - Джусу
Саке - Осаке
Банан - Банана
Овощи - Ясаи
Рис - Гохан
Хлеб - Пан
Футболка - Тишатсу
Мясо - Нико
Рыба - Сакана
Обувь - Кутсу
Сумка - Кабан
Часы - Токей
Кино - Еига
Телевизор - Тереби
Приятно познакомиться - Хаджимемаште
Прошу любить и жаловать - До:Зо Ёросику о негасимас
Я - Ваташи Ва
Россия - Рошиа
Япония - Нихон
Италия - Итариа
Франция - Фурансу
Национальность - Джин
Русский - РошиаДжин
Ваташи Ва РошиаДжин Дэс - Я русский
Дэс - Окончание предложений в настоящем времени
Мо - Тоже
Хай - Да
Ийе - Нет
Дева аримасен - Окончание отрицательного предложения в настоящем времени
Ваташи Ва НихонДжин Дэва Аримасен - Я не японец
Коре - Это(Близко к нам)
Соре - Это(Близко к собеседнику)
Аре - Это(Далеко от обоих собеседников)
Коре Ва Ринго Дэс - Это яблоко
Ка - Аналог "?", с помощью "ка" строятся вопросительные предложения
|Соре Ва Кохи Дэс Ка - Это кофе?(Предмет у собеседника в руках)
|Ийе, Коре Ва Кабан Дэс - Нет, это сумка
Нан - Что
|Коре Ва Нан Дэс Ка - Что это?(Предмет у нас)
|Соре Ва Кутсу Дэс - Это ботинки